11111111111111111111111
10000000000000000000001
10011110000111111111001
10011110000000000011001
10011111111110000011001
10000000000110000000001
10000000000111111100001
10111111000111111100001
10110000000110000000001
10110000000110000000001
10111111100000000000001
10000001100000000000001
11111111111111111111111
