11111111111111111111111
10000000000000001000001
10000000000000001000001
11111111111000001000001
10000000000000001000001
10000000000000001000001
10001000000000001000001
10001000000000000000001
1000100E0000C0000P00001
10001000001111111111111
10001000000000000000001
10001000000000000000001
11111111111111111111111
