111111111111111111111
100101111100011100001
100101111100011100001
100000000000011100001
100000000111111100001
111111000000000000001
111111000000000001111
100000000011110000111
100000000011110000111
111111111111111111111
