11111111111111111111111
10C00000000000001000001
100000000000000010C0001
11111111111000001000001
100000C0000000001000001
10000000000000001000001
10001000000000001000001
10001000000000000000001
100010000000C0000P00001
10001000001111111111111
10C0100000000000000E001
10001000C00000000000001
11111111111111111111111
