11111111111111111111111
10000000000000001000001
1000000C000000001000001
11111111111000001000001
100000000000C0001000001
10000000000000001000001
10001000000000001000001
10001000C00000000000001
10001000000000000P00001
10001000001111111111111
100010000000000000E0001
100010C0000000000000001
11111111111111111111111
