11111111111111111111111111111111
10000000000011111111111110000001
1111111000001111111110111000P001
11111110000011111111100000000001
11111111110000000000000111000001
10011111110000000000000110000001
100001111111110001111000Z0000001
10000111111111000111100000000001
10000001111110000111100000000001
10000000000000000111100000000001
1111100000C000000000000000000001
11111111000000000000000000000001
10000000111111111111111000000001
10000000111110000Z00000000000001
10000000111110000000000000000001
10000000111110000000000000000001
100E0000000000000C00000000000001
10000000000000000000000111100001
10000000000000000000000000000001
11111111111111111111111111111111
