111111111111111111111111111111111
100101111100000000000000000000001
100101111100011100001111111111111
100000000000011100000000001000001
100000000111111100001000001000001
111111000000000000001110001000001
111111000000000001111110001000001
100000000011110000111000001011111
100000000011110000111000000011111
111111111111111111111000111111111
110000000000000000000000000001111
111111111111111111000000111111111
100000000000001111110000111110011
100111110000001110000000111100011
110000000011111111111100000000111
111111111111111111111111111111111
