111111111111111111111111
1111111110000000000000001
100000000000000000000001
100000000000001111111111
100000000100000001000011
111111111111111111111111
