111111111111111111111111
11111P111000000000000001
100000000000000000000001
10000000E000001111111111
100000000100000001000011
111111111111111111111111
