1111111111111111
1P00000000000000
11111110000000E1
100000C000000001
1000000000000001
1111111111111111
