111111111111111111111101
111111111000000000000001
100000000000000000000001
100000000000001111111111
100000000100000001000011
111111111111111111111111
