111111111111111111111111
11111P11100000000C000001
1000000000000000000C0000
10000000E000001111111111
100000000100000001000011
111111111111111111111111
