11111111111111111111111
1000000C000000001000001
10000000000000001000001
11111111111000001000001
10000000000000001000001
10000000000000001000001
100010C0000000001000001
10001000000000000000001
10001000000C0000P000001
10001000001111111111111
10C0100000000C0000E0001
10001000000000000000001
11111111111111111111111
